<public>	<public>
<begin>	<begin>
<break>	<break>
ε	ε
<output>	<output>
<var>	<var>
<=>	<=>
<iden>	<iden>
<nextInt()>	<nextInt()>
<nextString()>	<nextString()>
<if>	<if>
<while>	<while>
<operand>	<operand>
<open-curlybrases>	<open-curlybrases>
<close-curlybrases>	<close-curlybrases>
<int>	<int>
<string>	<string>
<+>	<+>
<->	<->
<*>	<*>
</>	</>
<%>	<%>
<inc>	<inc>
<dec>	<dec>
<lt>	<lt>
<gt>	<gt>
<egt>	<egt>
<elt>	<elt>
<neq>	<neq>
<mod>	<public>
<stmts'>	ε, <output>, <int>, <string>, <while>, <var>, <if>
<stmt>	<output>, <int>, <string>, <while>, <var>, <if>
<assign>	<var>
<exp>	<iden>, <nextInt()>, <nextString()>
<input>	<nextInt()>, <nextString()>
<select>	<if>
<iteration>	<while>
<rel-exp>	<operand>
<body>	<open-curlybrases>
<dtypes>	<int>, <string>
<op>	<+>, <->, <*>, </>, <%>, <inc>, <dec>
<rel-op>	<=>, <lt>, <gt>, <egt>, <elt>, <neq>
<prog>	<public>
<declaration>	<int>, <string>
<stmts>	<output>, <int>, <string>, <while>, <var>, <if>
